NO ./textures/sailor1.xpm
SO ./textures/sailor3.xpm
EA ./textures/sailor0.xpm

WE 	./textures/sailor21.xpm	
C 147,202,237

F  255,255,255

     1111 1 1 1 1 1
    100S01 1        
     1111        