NO ./textures/sailor1.xpm
SO ./textures/sailor3.xpm
EA ./textures/sailor0.xpm

	WE 	./textures/sailor2.xpm	

C 147,202,237
F 255,255,255

111111		11111111111
10000011111100001
10100000100000101
11100000000000001
111100010001000D1
111010100010101N1
111110000000000011
11110000000111111
10000000000000001
10100001100001001        
1000001000000011     
11111111111111111       
10000000000000001																													1					
10100000100000101
10000000000000001
10001000100010001
10000000000000001
10101010001010101         
10000000000000001       
10001000100100001
10000000000000001
10100000100001001
10000000011100001
1111111111	111111