NO ./textures/sailor1.xpm
WE 	./textures/sailor2.xpm	
SO ./textures/sailor3.xpm
EA ./textures/sailor0.xpm

C 				147,202,237
F  255,255,255





      1111111111111111111111
      100000000N11000000001
      101100001110000000001
      111001010101010000001
      111111111111111111111
        111111111111111111111
      111111111111111111111
111111101100010110010000001
100000000001100000000000001
11000001111100010101111011011
11110111 11011101 101111111
11111111 11111111 111111111