NO ./textures/sailor1.xpm
SO ./textures/sailor3.xpm
EA ./textures/sailor0.xpm

	WE 	./textures/sailor2.xpm		

C    147,202,237
F 255,255,255 

	111111		111111111111
	10000011111100001
	10110000100000101
	11	1110000000000111
	11110001000100001
	11101010001010011
	111110000000000011
	11110000000111111
	10000000000000001
	1010W001100001001        
	1000001000000011     
	11111111111111111       
	10000000000000001																							1						1					
	10100000100000101
	10000000000000001
	10001000100010001
	10000000000000001
	101010100010101011111111111111111111111111111111111111111111111111111111111     
	100000000000000000000000000000000000000000000000000000000000000000000000001
	100010001001000000000000000000000000000000000010000000000000000001100000001
	1000000000000000000000000000000000000000000001000000000111111111110000000111
	10100000100000000000000000000000000000000000001000000000000000000110000000001
	10000000011100000000000000000000000000000000000000000000000000000000000000001
	11111111111111111111111111111111111111111111111111111111111111111111111111111