NO ./textures/sailor1.xpm
SO ./textures/sailor3.xpm
EA ./textures/sailor0.xpm

	WE 	./textures/sailor2.xpm	

C C147,202,237
F 255,255,255

111111		11111111111
10000011111100001
10100000100000101
11100000000000001
11110001000100001
11101010001010011
111110000000000011
11110000000111111
10000000000000001
10100001100001001        
1000001000000011     
11111111111111111       
10000000000000001																													1					
10100000100000101
10000000000000001
10001000100010001
10000000000000001
101010100010101011111111111111111111111111111111111111111111111111111111111     
100000000000000000000000000000000000000000000000000000000000000000000000001
100010001001000000000000000000000000000000000010000000000000000001100000001
1000000000000000N00000000000000000000000000000100000000011111111111000000011
10100000100000000000000000000000000000000000001000000000000000000110000000001
10000000011100000000000000000000000000000000000000000000000000000000000000001
11111111111111111111111111111111111111111111111111111111111111111111111111111