NO ./textures/sailor1.xpm
SO ./textures/sailor3.xpm
EA ./textures/sailor0.xpm

	WE 	./textures/sailor2.xpm	

C C147,202,23
F 2,255,255

11111111111111111
10000000000000001
10100000100000101
11100000000000001
111100010001000S1
11101010001010101
10000000000000011
11110000000111111
10000000000000001
10100001100001001        
1000001000000011     
11111111111111111       
10000000000000001
10100000100000101
10000000000000001
10001000100010001
10000000000000001
10101010001010101         
10000000000000001       
10001000100100001
10000000000000001
10100000100001001
10000000000000001
1111111111111111