NO ./textures/sailor1.xpm
SO ./textures/sailor3.xpm
EA ./textures/sailor0.xpm

WE 	./textures/sailor2.xpm	
C 147,202,237

F  255,255,255

111111
1000DW1
111111