NO ./textures/sailor1.xpm
SO ./textures/sailor3.xpm
EA ./textures/sailor0.xpm
	WE 	./textures/sailor2.xpm	

C	 147,202,237
F 255,255,255

11111111111111111
10000000000000001
10100D00100000101
11100000000000001
   1000100010001
11101010001010101
10000000000000001
11110000000111111
1000W000000000001
10100001100001001        
1000001  100000001      
11111111111111111       
10000000000000001
10100000100000101
10000000000000001
10001000100010001
10000000000000001        
10101010001010101        
10000000000000001       
10001000100100001
10000000000000001
10100000100001001
10000000000000001
11111111111111111